11111111111111111111111111111
10000111111111111000000001001
10PC00001111100000C0C00000CE1
10000C000000C00C0000000001001
111100000C0C0C000011111111111
11111111111111111111111111111



