111111111111111111111111111111
111000011111111111000000000111
111PC00001111111100C0C00000E11
111000C00000000000000000000111
11111100C0C0C0C000000011111111
111111110000000001100011111111
111111111111111111111111111111

