11111111111111111111111111111
11000011111111111011111111001
11PC00001111110000C0C00000CE1
11000C000000C00C0000000000001
111110000C0C0C000011111111111
11111111111111111111111111111



