111111111111
1PCCCECCCCC1
111111111111