111111111111111111
1000C000P0000000C1
100C0000000000CC01
1000000000000000C1
100000CCCC00000001
10000000E000000001
111111111111111111
