1111111111111111111111111111
1110000000000111100000001111
1000C000P0000000CC00C0000001
100C0000000000CC00CC00001111
1000000000000000CC000000E011
100000CCCCCCCCCCCCCCCCC11111
1000000000000000000000000001
1000011111111111000000000001
1000000000000000000000000001
1111111111111111111111111111

