1111111
10000E1
1000001
1PC0001
1111111
