1111111111111
1P00000000001
11110C0000001
10010000000E1
1111111111111
