1111111111111111111
10000000000000C0001
11110C0000001000011
10010000P00E1000111
1C01000000000000011
1000001111100010011
1000000001000010001
1000000001000010001
1000C00001000010001
10000000010C0010001
100C000001000010001
1111111111111111111
