11111111111111111
1P000000000C00001
10000C00000E00001
1000C000E000000E1
11111111111111111
