1111111
1P00001
1110111
1E11C11
1111111
