1111111111111111111
1P00000000000000001
11110C0000001000011
10010000000E1000111
1C01000000000000011
1000001111100010011
1000000001000010001
1000000001000010001
1000000001000010001
1000000001000010001
1000000001000010001
1111111111111111111
